1111111111111
1000000000001
1000011111001
1P0011E000000
1111111111111
