1111111111111111
1000001000000001
100000000C000001
100000C000000001
1000000000010001
1100000000000011
1000000000000001
10000000000000E1
1000000000100001
100100000000C001
1000010000000011
1C00000100000001
10000000000000P1
1111111111111111