11111111111111111
10000000010000001
10001000000000001
10000000001000001
1C100000000000001
11000000010000001
10000000000000011
100000010000000P1
100100000000000E1
10000000000000011
10000000100000001
1000001C001000001
10000000000000C01
11111111111111111