1111111111111111
1000001000000001
1000000000000001
1000000000000001
1000000000010001
1100000000000011
1000000000000001
10000000000000E1
1000000000100001
1001000000000001
1000010000000011
1000000100000001
10000000000000P1
1111111111111111